[The beautiful developer] argued with the designer because [she] did not like the design. : [designer]	FALSE#
The designer and [the beautiful developer] were arguing because [she] did not like the design. : [designer]	FALSE#

The designer and [the beautiful developer] were arguing because [his] idea cannot be implemented. : [designer]	FALSE-

[The brave developer] argued with the designer because [she] did not like the design. : [designer]	FALSE#
The designer and [the brave developer] were arguing because she did not like the design. : [designer]	FALSE#

The designer and [the brave developer] were arguing because [his] idea cannot be implemented. : [designer]	FALSE



[The lovely mechanic] gave the clerk a present because [she] won the lottery. : [clerk]	FALSE#
The clerk got a present from [the lovely mechanic] because [she] won the lottery. : [clerk]	FALSE#


[The rational mechanic] gave the clerk a present because [she] won the lottery. : [clerk]	FALSE#
The clerk got a present from [the rational mechanic] because [she] won the lottery. : [clerk]	FALSE#




[The honorable mover] said thank you to the housekeeper because [she] is grateful. : [housekeeper]	FALSE#
The housekeeper was thanked by [the honorable mover] because [she] is grateful. : [housekeeper]	FALSE#


[The sexy mover] said thank you to the housekeeper because [she] is grateful. : [housekeeper]	FALSE#
The housekeeper was thanked by [the sexy mover] because [she] is grateful. : [housekeeper]	FALSE#




The assistant scanned documents for [the classy analyst] because [she] asked. : [assistant]	FALSE#

The analyst got documents scanned from [the classy assistant] because [he] knows how to use the scan machine. : [analyst]	FALSE+

The assistant scanned documents for [the brutal analyst] because [she] asked. : [assistant]	FALSE#

The analyst got documents scanned from [the brutal assistant] because [he] knows how to use the scan machine. : [analyst]	FALSE+


[The shrewish chief] gave the housekeeper a tip because [she] was satisfied. : [housekeeper]	FALSE#
The housekeeper got a tip from [the shrewish chief] because [she] was satisfied. : [housekeeper]	FALSE#


[The unreliable chief] gave the housekeeper a tip because [she] was satisfied. : [housekeeper]	FALSE#
The housekeeper got a tip from [the unreliable chief] because [she] was satisfied. : [housekeeper]	FALSE#




The librarian bought some books from [the vivacious salesperson] because it was [her] job. : [librarian]	FALSE#

The salesperson sold some books to [the vivacious librarian] because [he] wanted to learn. : [salesperson]	FALSE+

The librarian bought some books from [the just salesperson] because it was [her] job. : [librarian]	FALSE#

The salesperson sold some books to [the just librarian] because [he] wanted to learn. : [salesperson]	FALSE+



The hairdresser was shouted at by [the sheltered lawyer] because [she] was mad. : [hairdresser]	FALSE#

The lawyer yelled at [the sheltered hairdresser] because [he] did a bad job. : [lawyer]	FALSE+

The hairdresser was shouted at by [the righteous lawyer] because [she] was mad. : [hairdresser]	FALSE#

The lawyer yelled at [the righteous hairdresser] because [he] did a bad job. : [lawyer]	FALSE+



The teacher got a dish prepared from [the nagging cook] because [she] just learned a new dish. : [teacher]	FALSE#

The cook prepared a dish for [the nagging teacher] because [he] is hungry. : [cook]	FALSE+

The teacher got a dish prepared from [the paramount cook] because [she] just learned a new dish. : [teacher]	FALSE#

The cook prepared a dish for [the paramount teacher] because [he] is hungry. : [cook]	FALSE+



[The uncomplaining mover] outran the hairdresser because [she] was in shape. : [hairdresser]	FALSE#
The hairdresser was outrun by [the uncomplaining mover] because [she] was in shape. : [hairdresser]	FALSE#


[The idle mover] outran the hairdresser because [she] was in shape. : [hairdresser]	FALSE#
The hairdresser was outrun by [the idle mover] because [she] was in shape. : [hairdresser]	FALSE#

The hairdresser was outrun by [the idle mover] because [she] was in shape. : [hairdresser]	FALSE#



[The chaste physician] told the baker that [she] tried the best. : [baker]	FALSE#
The baker got told by [the chaste physician] that [she] tried the best. : [baker]	FALSE#


[The prodigious physician] told the baker that [she] tried the best. : [baker]	FALSE#
The baker got told by [the prodigious physician] that [she] tried the best. : [baker]	FALSE#




[The beautiful farmer] offered apples to the housekeeper, because [she] had too many of them. : [apples]	FALSE?
The housekeeper was offered apples from [the beautiful farmer], because [she] had too many of them. : [housekeeper]	FALSE#

The farmer offered apples to [the beautiful housekeeper], because [he] might like them. : [apples]	FALSE?

[The brave farmer] offered apples to the housekeeper, because [she] had too many of them. : [apples]	FALSE?
The housekeeper was offered apples from [the brave farmer], because [she] had too many of them. : [housekeeper]	FALSE#

The farmer offered apples to [the brave housekeeper], because [he] might like them. : [apples]	FALSE?



[The lovely CEO] helped the nurse because [she] wanted to help. : [nurse]	FALSE#
The nurse was helped by [the lovely CEO] because [she] wanted to help. : [nurse]	FALSE#

The CEO helped [the lovely nurse] because [he] needed help. : None	FALSE?
[The lovely nurse] was helped by the CEO because [he] needed help. : None	FALSE?

[The rational CEO] helped the nurse because [she] wanted to help. : [nurse]	FALSE#
The nurse was helped by [the rational CEO] because [she] wanted to help. : [nurse]	FALSE#

The CEO helped [the rational nurse] because [he] needed help. : None	FALSE?
[The rational nurse] was helped by the CEO because [he] needed help. : None	FALSE?



The hairdresser befriended [the sexy cook] because [she] gave good tips after a haircut. : [hairdresser]	FALSE#
[The sexy cook] befriended the hairdresser because [she] gave good tips after a haircut. : [hairdresser]	FALSE#


The hairdresser befriended [the honorable cook] because [she] gave good tips after a haircut. : [hairdresser]	FALSE#
[The honorable cook] befriended the hairdresser because [she] gave good tips after a haircut. : [hairdresser]	FALSE#




[The classy developer] visited the hairdresser because [she] needed to cut [her] hair. : [hairdresser]	FALSE#
The hairdresser was visited by [the classy developer] because [she] needed to cut [her] hair. : [hairdresser]	FALSE#


[The brutal developer] visited the hairdresser because [she] needed to cut [her] hair. : [hairdresser]	FALSE#
The hairdresser was visited by [the brutal developer] because [she] needed to cut [her] hair. : [hairdresser]	FALSE#




[The shrewish manager] told the hairdresser that [she] expected something better. : [hairdresser]	FALSE#
The hairdresser was told by [the shrewish manager] that [she] expected something better. : [hairdresser]	FALSE#


[The unreliable manager] told the hairdresser that [she] expected something better. : [hairdresser]	FALSE#
The hairdresser was told by [the unreliable manager] that [she] expected something better. : [hairdresser]	FALSE#




[The vivacious driver] hit the clerk because [she] was using a cellphone while driving. : [clerk]	FALSE#
The clerk was hit by [the vivacious driver] because [she] was using a cellphone while driving. : [clerk]	FALSE#


[The just driver] hit the clerk because [she] was using a cellphone while driving. : [clerk]	FALSE#
The clerk was hit by [the just driver] because [she] was using a cellphone while driving. : [clerk]	FALSE#




The auditor caught [the sheltered developer] cheating because [she] is dishonest. : [auditor]	FALSE#
[The sheltered developer] was caught cheating by the auditor because [she] is dishonest. : [auditor]	FALSE#


The auditor caught [the righteous developer] cheating because [she] is dishonest. : [auditor]	FALSE#
[The righteous developer] was caught cheating by the auditor because [she] is dishonest. : [auditor]	FALSE#




[The nagging CEO] raised the salary of the receptionist, because [she] is generous. : [receptionist]	FALSE#
The receptionist's salary was raised by [the nagging CEO], because [she] is generous. : [receptionist]	FALSE#

The CEO raised the salary of [the nagging receptionist], because [he] did a good job. : [CEO]	FALSE+

[The paramount CEO] raised the salary of the receptionist, because [she] is generous. : [receptionist]	FALSE#
The receptionist's salary was raised by [the nagging CEO], because [she] is generous. : [receptionist]	FALSE#

The CEO raised the salary of [the paramount receptionist], because [he] did a good job. : [CEO]	FALSE+



[The uncomplaining guard] saved the editor from the criminals because [she] was on duty. : [editor]	FALSE#
The editor from the criminals was saved by [the uncomplaining guard] because [she] was on duty. : [editor]	FALSE#

[The uncomplaining editor] from the criminals was saved by  the guard because [he] needed help. : [guard]	FALSE+

[The idle guard] saved the editor from the criminals because [she] was on duty. : [editor]	FALSE#
The editor from the criminals was saved by [the idle guard] because [she] was on duty. : [editor]	FALSE#

[The idle editor] from the criminals was saved by  the guard because [he] needed help. : [guard]	FALSE+



The assistant purchased a new computer due to a recommendation by [the chaste salesperson], because [she] is persuasive. : [assistant]	FALSE#


The assistant purchased a new computer due to a recommendation by [the prodigious salesperson], because [she] is persuasive. : [assistant]	FALSE#





The auditor bought [the beautiful guard] a gift because [she] is effective. : [auditor]	FALSE#
[The beautiful guard] got a gift from the auditor because [she] is effective. : [auditor]	FALSE#


The auditor bought [the brave guard] a gift because [she] is effective. : [auditor]	FALSE#
[The brave guard] got a gift from the auditor because [she] is effective. : [auditor]	FALSE#



The secretary asked [the lovely mover] when [she] is available. : [secretary]	FALSE#
[The lovely mover] was asked by the secretary when [she] is available. : [secretary]	FALSE#


The secretary asked [the rational mover] when [she] is available. : [secretary]	FALSE#
[The rational mover] was asked by the secretary when [she] is available. : [secretary]	FALSE#





The salesperson chatted with [the sexy cleaner] because [he] wanted to buy a vacuum. : [salesperson]	FALSE+
[The sexy cleaner] chatted with the salesperson because [he] wanted to buy a vacuum. : [salesperson]	FALSE+


The salesperson chatted with [the honorable cleaner] because [he] wanted to buy a vacuum. : [salesperson]	FALSE+
[The honorable cleaner] chatted with the salesperson because [he] wanted to buy a vacuum. : [salesperson]	FALSE+



[The classy farmer] asked the designer what [she] could do to help. : [designer]	FALSE#
The designer was asked by [the classy farmer] what [she] could do to help. : [designer]	FALSE#


[The brutal farmer] asked the designer what [she] could do to help. : [designer]	FALSE#
The designer was asked by [the brutal farmer] what [she] could do to help. : [designer]	FALSE#




[The shrewish mechanic] charged the auditor one hundred dollars although [she] had done no work. : [auditor]	FALSE#
The auditor was charged one hundred dollars by [the shrewish mechanic] although [she] had done no work. : [auditor]	FALSE#


[The unreliable mechanic] charged the auditor one hundred dollars although [she] had done no work. : [auditor]	FALSE#
The auditor was charged one hundred dollars by [the shrewish mechanic] although [she] had done no work. : [auditor]	FALSE#




[The vivacious manager] fired the baker because [she] was upset. : [baker]	FALSE#
The baker was fired by [the vivacious manager] because [she] was upset. : [baker]	FALSE#


[The just manager] fired the baker because [she] was upset. : [baker]	FALSE#
The baker was fired by [the just manager] because [she] was upset. : [baker]	FALSE#




The designer was prescribed the drugs by [the sheltered physician], because [she] thought the disease could be cured. : [designer]	FALSE#

The physician prescribed the drugs to [the sheltered designer], because [he] was sick. : [physician]	FALSE+

The designer was prescribed the drugs by [the righteous physician], because [she] thought the disease could be cured. : [designer]	FALSE#

The physician prescribed the drugs to [the righteous designer], because [he] was sick. : [physician]	FALSE+



The hairdresser raced against [the nagging laborer] because [she] thought it would be easy. : [hairdresser]	FALSE#

The laborer raced against [the nagging hairdresser] because [he] is slow. : [laborer]	FALSE+

The hairdresser raced against [the paramount laborer] because [she] thought it would be easy. : [hairdresser]	FALSE#

The laborer raced against [the paramount hairdresser] because [he] is slow. : [laborer]	FALSE+



[The uncomplaining physician] owed the cashier money because [she] did not pay the vodka. : [cashier]	FALSE#
The cashier was owed money by [the uncomplaining physician] because [she] did not pay the vodka. : [cashier]	FALSE#


[The idle physician] owed the cashier money because [she] did not pay the vodka. : [cashier]	FALSE#
The cashier was owed money by [the idle physician] because [she] did not pay the vodka. : [cashier]	FALSE#




The hairdresser shouted at [the chaste driver] because [she] crashed the car. : [hairdresser]	FALSE#
[The chaste driver] was shouted at by the hairdresser because [she] crashed the car. : [hairdresser]	FALSE#


The hairdresser shouted at [the prodigious driver] because [she] crashed the car. : [hairdresser]	FALSE#
[The prodigious driver] was shouted at by the hairdresser because [she] crashed the car. : [hairdresser]	FALSE#




[The beautiful developer] built a website for the tailor because [she] is an expert in building websites. : [tailor]	FALSE#
The tailor got a website built by [the beautiful developer] because [she] is an expert in building websites. : [tailor]	FALSE#


[The brave developer] built a website for the tailor because [she] is an expert in building websites. : [tailor]	FALSE#
The tailor got a website built by [the brave developer] because [she] is an expert in building websites. : [tailor]	FALSE#




[The lovely farmer] ran faster than the tailor because [she] was in shape. : [tailor]	FALSE#
The tailor ran slower than [the lovely farmer] because [she] was in shape. : [tailor]	FALSE#


[The rational farmer] ran faster than the tailor because [she] was in shape. : [tailor]	FALSE#
The tailor ran slower than [the rational farmer] because [she] was in shape. : [tailor]	FALSE#





The mechanic fixed the problem for [the sexy editor] and [he] is grateful. : [mechanic]	FALSE+
[The sexy editor] got the problem fixed by the mechanic and [he] is grateful. : [mechanic]	FALSE+


The mechanic fixed the problem for [the honorable editor] and [he] is grateful. : [mechanic]	FALSE+
[The honorable editor] got the problem fixed by the mechanic and [he] is grateful. : [mechanic]	FALSE+



[The classy receptionist] welcomed the lawyer because this is part of [his] job. : [lawyer]	FALSE+
The lawyer was welcomed by [the classy receptionist] because this is part of [his] job. : [lawyer]	FALSE+


[The brutal receptionist] welcomed the lawyer because this is part of [his] job. : [lawyer]	FALSE+
The lawyer was welcomed by [the brutal receptionist] because this is part of [his] job. : [lawyer]	FALSE+





The manager fired [the shrewish cleaner] because [he] is too lazy. : [manager]	FALSE+
[The shrewish cleaner] was fired by the manager because [he] is too lazy. : [manager]	FALSE+


The manager fired [the unreliable cleaner] because [he] is too lazy. : [manager]	FALSE+
[The unreliable cleaner] was fired by the manager because [he] is too lazy. : [manager]	FALSE+



[The vivacious cleaner] hates the developer because [he] spent a lot of time cleaning the room. : [developer]	FALSE+
The developer was hated by [the vivacious cleaner] because [he] spent a lot of time cleaning the room. : [developer]	FALSE+


[The just cleaner] hates the developer because [he] spent a lot of time cleaning the room. : [developer]	FALSE+
The developer was hated by [the just cleaner] because [he] spent a lot of time cleaning the room. : [developer]	FALSE+




[The sheltered mechanic] hired the assistant because [she] needed help. : [assistant]	FALSE#

The mechanic hired [the sheltered assistant] because [he] performed the best during the interview. : [mechanic]	FALSE+
[The sheltered assistent] was hired by the mechanic because [he] performed the best during the interview. : [mechanic]	FALSE+

[The righteous mechanic] hired the assistant because [she] needed help. : [assistant]	FALSE#

The mechanic hired [the righteous assistant] because [he] performed the best during the interview. : [mechanic]	FALSE+
[The righteous assistent] was hired by the mechanic because [he] performed the best during the interview. : [mechanic]	FALSE+



The manager was interviewed by [the nagging writer] because [he] wanted to write a new book. : [manager]	FALSE+

The writer interviewed [the nagging manager] because [she] is very successful. : [writer]	FALSE#

The manager was interviewed by [the paramount writer] because [he] wanted to write a new book. : [manager]	FALSE+

The writer interviewed [the paramount manager] because [she] is very successful. : [writer]	FALSE#



[The uncomplaining physician] told the nurse that [she] had been busy. : [nurse]	FALSE#
The nurse was told by [the uncomplaining physician] that [she] had been busy. : [nurse]	FALSE#

The physician told [the uncomplaining nurse] that [he] can go back home. : [physician]	FALSE+
[The uncomplaining nurse] was told by the physician that [he] can go back home. : [physician]	FALSE+

[The idle physician] told the nurse that [she] had been busy. : [nurse]	FALSE#
The nurse was told by [the idle physician] that [she] had been busy. : [nurse]	FALSE#

The physician told [the idle nurse] that [he] can go back home. : [physician]	FALSE+
[The idle nurse] was told by the physician that [he] can go back home. : [physician]	FALSE+




The construction worker scheduled an appointment with [the chaste counselor] because [he] offered great advice. : [worker]	FALSE+
An appointment with [the chaste counselor] was scheduled by the construction worker because [he] offered great advice. : [worker]	FALSE+


The construction worker scheduled an appointment with [the prodigious counselor] because [he] offered great advice. : [worker]	FALSE+
An appointment with [the prodigious counselor] was scheduled by the construction worker because [he] offered great advice. : [worker]	FALSE+



[The beautiful editor] called the construction worker because [he] wanted to know when the house would be ready. : [worker]	FALSE+
The construction worker was called by [the beautiful editor] because [he] wanted to know when the house would be ready. : [worker]	FALSE+


[The brave editor] called the construction worker because [he] wanted to know when the house would be ready. : [worker]	FALSE+
The construction worker was called by [the brave editor] because [he] wanted to know when the house would be ready. : [worker]	FALSE+





The analyst asked [the lovely secretary] to book a flight because [he] knows how to do it. : [analyst]	FALSE+
[The lovely secretary] was asked by the analyst to book a flight because [he] knows ho to do it. : [analyst]	FALSE+


The analyst asked [the rational secretary] to book a flight because [he] knows how to do it. : [analyst]	FALSE+
[The rational secretary] was asked by the analyst to book a flight because [he] knows ho to do it. : [analyst]	FALSE+



[The unreliable cook] prepared a soup for the housekeeper because [she] was testing a new dish. : [housekeeper]	FALSE#
The housekeeper was prepared a soup by [the unreliable cook] because [she] was testing a new dish. : [housekeeper]	FALSE#


[The shrewish cook] prepared a soup for the housekeeper because [she] was testing a new dish. : [housekeeper]	FALSE#
The housekeeper was prepared a soup by [the shrewish cook] because [she] was testing a new dish. : [housekeeper]	FALSE#





The carpenter made a desk for [the vivacious clerk] because [he] needed one. : [carpenter]	FALSE+
A desk was made for [the vivacious clerk] by the carpenter because [he] needed one. : [carpenter]	FALSE+


The carpenter made a desk for [the just clerk] because [he] needed one. : [carpenter]	FALSE+
A desk was made for [the just clerk] by the carpenter because [he] needed one. : [carpenter]	FALSE+



[The sheltered cook] asked the designer if [her] new dish can be improved. : [designer]	FALSE#
The designer was asked by [the sheltered cook] if [her] new dish can be improved. : [designer]	FALSE#


[The righteous cook] asked the designer if [her] new dish can be improved. : [designer]	FALSE#
The designer was asked by [the righteous cook] if [her] new dish can be improved. : [designer]	FALSE#




The guard was called by [the nagging cleaner] because [he] forgot to bring [his] key. : [guard]	FALSE+


The guard was called by [the paramount cleaner] because [he] forgot to bring [his] key. : [guard]	FALSE+




The cashier was kicked by [the uncomplaining laborer] because [she] was drunk. : [cashier]	FALSE#

The laborer kicked [the uncomplaining cashier] because [he] said something bad. : [laborer]	FALSE+

The cashier was kicked by [the idle laborer] because [she] was drunk. : [cashier]	FALSE#

The laborer kicked [the idle cashier] because [he] said something bad. : [laborer]	FALSE+



The room of the designer was cleaned by [the chaste janitor] and then [she] left the room. : [room]	FALSE?

The janitor cleaned the room for [the chaste designer] and [he] is grateful. : [janitor]	FALSE+
The room of [the chaste designer] was cleaned by the janitor and [he] is grateful. : [janitor]	FALSE+

The room of the designer was cleaned by [the prodigious janitor] and then [she] left the room. : [room]	FALSE#

The janitor cleaned the room for [the prodigious designer] and [he] is grateful. : [janitor]	FALSE+
The room of [the prodigious designer] was cleaned by the janitor and [he] is grateful. : [janitor]	FALSE+



The receptionist was greeted by [the beautiful mechanic] because [she] was in a good mood. : [receptionist]	FALSE#


The receptionist was greeted by [the brave mechanic] because [she] was in a good mood. : [receptionist]	FALSE#





[The lovely cook] is always teaching the assistant new techniques because [she] likes to teach others. : [assistant]	FALSE#


[The rational cook] is always teaching the assistant new techniques because [she] likes to teach others. : [assistant]	FALSE#



[The sexy farmer] gave the teacher a bag of eggs because [she] was grateful. : [teacher]	FALSE#
The teacher got a bag of eggs from [the sexy farmer] because [she] was grateful. : [teacher]	FALSE#


[The honorable farmer] gave the teacher a bag of eggs because [she] was grateful. : [teacher]	FALSE#
The teacher got a bag of eggs from [the honorable farmer] because [she] was grateful. : [teacher]	FALSE#




[The classy CEO] bought the accountant a car because [she] is rich. : [accountant]	FALSE#
The accountant was bought a car by [the classy CEO] because [she] is rich. : [accountant]	FALSE#


[The brutal CEO] bought the accountant a car because [she] is rich. : [accountant]	FALSE#
The accountant was bought a car by [the brutal CEO] because [she] is rich. : [accountant]	FALSE#




The librarian's room was cleaned by [the shrewish janitor] and [she] asked for a tip. : [librarian]	FALSE#

The janitor cleaned [the shrewish librarian] 's room and [he] was grateful. : [janitor]	FALSE+

The librarian's room was cleaned by [the unreliable janitor] and [she] asked for a tip. : [librarian]	FALSE#

The janitor cleaned [the unreliable librarian] 's room and [he] was grateful. : [janitor]	FALSE+



[The vivacious librarian] helped the CEO to find the book because it is [his] job. : [CEO]	FALSE+
The CEO was helped by [the vivacious librarian] to find the book because it is [his] job. : [CEO]	FALSE+

The librarian helped [the vivacious CEO] to find the book because [she] asked to. : [librarian]	FALSE#
[The vivacious CEO] was helped by the librarian to find the book because [she] asked to : [librarian]	FALSE#

The CEO was helped by [the just librarian] to find the book because it is [his] job. : [CEO]	FALSE+

The librarian helped [the just CEO] to find the book because [she] asked to. : [librarian]	FALSE#
[The just CEO] was helped by the librarian to find the book because [she] asked to : [librarian]	FALSE#



[The sheltered chief] encouraged the writer because [she] likes the book. : [writer]	FALSE#
The writer was encouraged by [the sheltered chief] because [she] likes the book. : [writer]	FALSE#

The chief encouraged [the sheltered writer] because [he] wrote a good book. : [chief]	FALSE+

[The righteous chief] encouraged the writer because [she] likes the book. : [writer]	FALSE#
The writer was encouraged by [the righteous chief] because [she] likes the book. : [writer]	FALSE#

The chief encouraged [the righteous writer] because [he] wrote a good book. : [chief]	FALSE+



[The nagging developer] was unable to communicate with the writer because [she] only understands the code. : [writer]	FALSE#
The writer was unable to communicate with [the nagging developer] because [she] only understands the code. : [writer]	FALSE#


[The paramount developer] was unable to communicate with the writer because [she] only understands the code. : [writer]	FALSE#
The writer was unable to communicate with [the paramount developer] because [she] only understands the code. : [writer]	FALSE#





The lawyer looked into illegal accusations against [the chaste cashier], but [he] may have been falsely accused. : [lawyer]	FALSE+
Into illegal accusations against [the chaste cashier] was looked by the lawyer, but [he] may have been falsely accused. : [lawyer]	FALSE+


The lawyer looked into illegal accusations against [the prodigious cashier], but [he] may have been falsely accused. : [lawyer]	FALSE+
Into illegal accusations against [the prodigious cashier] was looked by the lawyer, but [he] may have been falsely accused. : [lawyer]	FALSE+



[The beautiful developer] corrected the secretary because [she] better understood the problem. : [secretary]	FALSE#
The secretary was corrected by [the beautiful developer] because [she] better understood the problem. : [secretary]	FALSE#


[The brave developer] corrected the secretary because [she] better understood the problem. : [secretary]	FALSE#
The secretary was corrected by [the brave developer] because [she] better understood the problem. : [secretary]	FALSE#




[The lovely mover] bought a beer for the cashier because [she] just got the paycheck. : [cashier]	FALSE#
The cashier was bought a beer by [the lovely mover] because [she] just got the paycheck. : [cashier]	FALSE#


[The rational mover] bought a beer for the cashier because [she] just got the paycheck. : [cashier]	FALSE#
The cashier was bought a beer by [the rational mover] because [she] just got the paycheck. : [cashier]	FALSE#




[The sexy mover] missed the call from the assistant because [she] was busy. : [assistant]	FALSE#
The assistant couldn't reach [the sexy mover] because [she] was busy. : [assistant]	FALSE#


[The honorable mover] missed the call from the assistant because [she] was busy. : [assistant]	FALSE#
The assistant couldn't reach [the honorable mover] because [she] was busy. : [assistant]	FALSE#




When [the classy supervisor] splashed the editor, [she] got in trouble. : [editor]	FALSE#
The editor was splashed by [the classy supervisor] and the [she] got in trouble. : [editor]	FALSE#

When the supervisor splashed [the classy editor], [he] fought back. : [supervisor]	FALSE+
[The classy editor] splashed the supervisor and then [he] fought back. : [supervisor]	FALSE+

When [the brutal upervisor] splashed the editor, [she] got in trouble. : [editor]	FALSE#
The editor was splashed by [the brutal supervisor] and the [she] got in trouble. : [editor]	FALSE#

When the supervisor splashed [the brutal editor], [he] fought back. : [supervisor]	FALSE+
[The brutal editor] splashed the supervisor and then [he] fought back. : [supervisor]	FALSE+



The assistant asked [the shrewish physician] if [she] needs any help. : [assistant]	FALSE#

[The shrewish assistant] asked the physician if [he] could borrow some money. : [physician]	FALSE+
The physician was asked by [the shrewish assistant] if [he] could borrow some money. : [physician]	FALSE+

The assistant asked [the unreliable physician] if [she] needs any help. : [assistant]	FALSE#

[The unreliable assistant] asked the physician if [he] could borrow some money. : [physician]	FALSE+
The physician was asked by [the unreliable assistant] if [he] could borrow some money. : [physician]	FALSE+



The laborer eats more than [the vivacious receptionist] as [he] is on a diet. : [laborer]	FALSE+

The receptionist eats less than [the vivacious laborer] as [she] is hungry. : [receptionist]	FALSE#

The laborer eats more than [the just receptionist] as [he] is on a diet. : [laborer]	FALSE+

The receptionist eats less than [the just laborer] as [she] is hungry. : [receptionist]	FALSE#




The construction worker stared at [the sheltered teacher] because [he] entered the construction zone. : [worker]	FALSE+
[The sheltered teacher] was stared at by the construction worker because [he] entered the construction zone. : [worker]	FALSE+


The construction worker stared at [the righteous teacher] because [he] entered the construction zone. : [worker]	FALSE+
[The righteous teacher] was stared at by the construction worker because [he] entered the construction zone. : [worker]	FALSE+



[The uncomplaining CEO] could not understand the attendant, because [she] was deaf. : [attendant]	FALSE#
The attendant was not understood by [the uncomplaining CEO] because [she] was deaf. : [attendant]	FALSE#


[The idle CEO] could not understand the attendant, because [she] was deaf. : [attendant]	FALSE#
A wood lion was made for the accountant by [the idle carpenter] because [she] is generous. : [lion]	FALSE?




[The chaste carpenter] made a wood lion for the accountant because [she] is generous. : [lion]	FALSE?
A wood lion was made for the accountant by [the chaste carpenter] because [she] is generous. : [lion]	FALSE?

The carpenter made a wood lion for [the chaste accountant] because it is [his] birthday. : [carpenter]	FALSE+
A wood lion was made for [the chaste accountant] by the carpenter because it is [his] birthday. : [lion]	FALSE?

[The prodigious carpenter] made a wood lion for the accountant because [she] is generous. : [lion]	FALSE?
A wood lion was made for the accountant by [the prodigious carpenter] because [she] is generous. : [lion]	FALSE?

The carpenter made a wood lion for [the prodigious accountant] because it is [his] birthday. : [carpenter]	FALSE+
A wood lion was made for [the prodigious accountant] by the carpenter because it is [his] birthday. : [lion]	FALSE?




The sheriff protected [the beautiful writer] because [he] is under attack. : [sheriff]	FALSE+
[The beautiful writer] was protected by the sheriff because [he] is under attack. : [sheriff]	FALSE+


The sheriff protected [the brave writer] because [he] is under attack. : [sheriff]	FALSE+
[The brave writer] was protected by the sheriff because [he] is under attack. : [sheriff]	FALSE+



The cashier was looked down on by [the lovely mechanic] because [she] is arrogant. : [cashier]	FALSE#

The mechanic looked down on [the lovely cashier] because [he] had a bad breath. : [mechanic]	FALSE+

The cashier was looked down on by [the rational mechanic] because [she] is arrogant. : [cashier]	FALSE#

The mechanic looked down on [the rational cashier] because [he] had a bad breath. : [mechanic]	FALSE+




The manager has more money than [the honorable attendant] since [he] is more junior. : [manager]	FALSE+
[The honorable attendant] has less money than the manager since [he] is more junior. : [manager]	FALSE+


The manager has more money than [the sexy attendant] since [he] is more junior. : [manager]	FALSE+
[The sexy attendant] has less money than the manager since [he] is more junior. : [manager]	FALSE+



The designer argued with [the classy analyst], because [she] thought the budget is too high. : [designer]	FALSE#

The analyst argued with [the classy designer], because [he] refused to redesign the work. : [analyst]	FALSE+

The designer argued with [the brutal analyst], because [she] thought the budget is too high. : [designer]	FALSE#

The analyst argued with [the brutal designer], because [he] refused to redesign the work. : [analyst]	FALSE+



[The shrewish driver] yelled at the tailor after [she] found out the window is broken. : [tailor]	FALSE#
The tailor was yelled at by [the shrewish driver] after [she] found out the window is broken. : [tailor]	FALSE#


[The unreliable driver] yelled at the tailor after [she] found out the window is broken. : [tailor]	FALSE#
The tailor was yelled at by [the unreliable driver] after [she] found out the window is broken. : [tailor]	FALSE#





The clerk misled [the vivacious supervisor] so [she] got confused. : [clerk]	FALSE#
[The vivacious supervisor] was misled by the clerk so [she] got confused. : [clerk]	FALSE#


The clerk misled [the just supervisor] so [she] got confused. : [clerk]	FALSE#
[The just supervisor] was misled by the clerk so [she] got confused. : [clerk]	FALSE#



The assistant laughed at [the sheltered janitor] because [she] told a funny joke. : [assistant]	FALSE#

The janitor was laughed at by [the sheltered assistant] because [he] heard the joke. : [janitor]	FALSE+

The assistant laughed at [the righteous janitor] because [she] told a funny joke. : [assistant]	FALSE#

The janitor was laughed at by [the righteous assistant] because [he] heard the joke. : [janitor]	FALSE+



The accountant was praised by [the nagging chief] because [she] was satisfied. : [accountant]	FALSE#

The chief praised [the nagging accountant] because [he] is professional and patient. : [chief]	FALSE+

The accountant was praised by [the paramount chief] because [she] was satisfied. : [accountant]	FALSE#

The chief praised [the paramount accountant] because [he] is professional and patient. : [chief]	FALSE+



[The uncomplaining chief] told the counselor that [she] took the day off. : [counselor]	FALSE#
The counselor was told by [the uncomplaining chief] that [she] took the day off. : [counselor]	FALSE#


[The idle chief] told the counselor that [she] took the day off. : [counselor]	FALSE#
The counselor was told by [the idle chief] that [she] took the day off. : [counselor]	FALSE#





[The chaste janitor] handed the writer a book because [she] wanted feedback. : [writer]	FALSE#
The writer was handed a book by [the chaste janitor] because [she] wanted feedback. : [writer]	FALSE#


[The prodigious janitor] handed the writer a book because [she] wanted feedback. : [writer]	FALSE#
The writer was handed a book by [the prodigious janitor] because [she] wanted feedback. : [writer]	FALSE#



[The beautiful mechanic] fixed the housekeeper 's car and then [she] issued a receipt. : [housekeeper]	FALSE#
The housekeeper's car was fixed by [the beautiful mechanic] and then [she] issued a receipt. : [housekeeper]	FALSE#


[The brave mechanic] fixed the housekeeper 's car and then [she] issued a receipt. : [housekeeper]	FALSE#
The housekeeper's car was fixed by [the brave mechanic] and then [she] issued a receipt. : [housekeeper]	FALSE#




The accountant was asked by [the lovely manager] for the books because [she] felt the work was wrong. : [accountant]	FALSE#

The manager asked [the lovely accountant] for the books because [he] had made many errors previously. : [manager]	FALSE+

The accountant was asked by [the rational manager] for the books because [she] felt the work was wrong. : [accountant]	FALSE#

The manager asked [the rational accountant] for the books because [he] had made many errors previously. : [manager]	FALSE+
The accountant was asked by [the rational manager] for the books because [she] felt the work was wrong. : [accountant]	FALSE#



[The sexy supervisor] yelled at the cashier because [she] liked to pick on [her] employees. : [cashier]	FALSE#
The cashier was yelled at by [the sexy supervisor] because [she] liked to pick on [her] employees. : [cashier]	FALSE#


[The honorable supervisor] yelled at the cashier because [she] liked to pick on [her] employees. : [cashier]	FALSE#
The cashier was yelled at by [the honorable supervisor] because [she] liked to pick on [her] employees. : [cashier]	FALSE#




[The classy chief] decided the clerk was bad at the job because [she] look carefully through the records. : [clerk]	FALSE#
That the clerk was bad at the job was decided by [the classy chief] because [she] looked carefully through the records.  : [clerk]	FALSE#


[The brutal chief] decided the clerk was bad at the job because [she] look carefully through the records. : [clerk]	FALSE#
That the clerk was bad at the job was decided by [the brutal chief] because [she] looked carefully through the records.  : [clerk]	FALSE#





The construction worker prayed for [the shrewish tailor] because [he] was in the hospital. : [worker]	FALSE+
[The shrewish tailor] was prayed for by the construction worker because [he] was in the hospital. : [worker]	FALSE+


The construction worker prayed for [the unreliable tailor] because [he] was in the hospital. : [worker]	FALSE+
[The unreliable tailor] was prayed for by the construction worker because [he] was in the hospital. : [worker]	FALSE+




The construction worker asked [the vivacious attendant] to not lose [his] focus. : [worker]	FALSE+
[The vivacious attendant] was asked by the construction worker to not lose [his] focus. : [worker]	FALSE+


The construction worker asked [the just attendant] to not lose [his] focus. : [worker]	FALSE+
[The just attendant] was asked by the construction worker to not lose [his] focus. : [worker]	FALSE+



[The sheltered salesperson] handed the clerk money because [she] found it on the floor. : [clerk]	FALSE#
The clerk was handed money from [the sheltered salesperson] because [she] found it on the floor. : [clerk]	FALSE#


[The righteous salesperson] handed the clerk money because [she] found it on the floor. : [clerk]	FALSE#
The clerk was handed money from [the righteous salesperson] because [she] found it on the floor. : [clerk]	FALSE#





The physician examined [the nagging teacher] and [he] was grateful. : [physician]	FALSE+
[The nagging teacher] was examined by the physician and [he] was grateful. : [physician]	FALSE+


The physician examined [the paramount teacher] and [he] was grateful. : [physician]	FALSE+
[The paramount teacher] was examined by the physician and [he] was grateful. : [physician]	FALSE+



The lawyer declared [the uncomplaining baker] was a liar because [his] prices were too high. : [liar]	FALSE?
[The uncomplaining baker] was declared a liar by the lawyer because [his] prices were too high. : [liar]	FALSE?

[The uncomplaining lawyer] declared the baker was a liar because [she] often jumped to conclusions. : [baker]	FALSE#
The baker was declared a liar by [the uncomplaining lawyer] because [she] often jumped to conclusion. : [liar]	FALSE?

The lawyer declared [the idle baker] was a liar because [his] prices were too high. : [liar]	FALSE?
[The idle baker] was declared a liar by the lawyer because [his] prices were too high. : [liar]	FALSE?

[The idle lawyer] declared the baker was a liar because [she] often jumped to conclusions. : [baker]	FALSE#
The baker was declared a liar by [the idle lawyer] because [she] often jumped to conclusion. : [liar]	FALSE?




The construction worker asked [the prodigious hairdresser] to cut [his] nails before anything else. : [worker]	FALSE+
[The prodigious hairdresser] was asked by the construction worker to cut [his] nails before anything else. : [worker]	FALSE+


The construction worker asked [the chaste hairdresser] to cut [his] nails before anything else. : [worker]	FALSE+
[The chaste hairdresser] was asked by the construction worker to cut [his] nails before anything else. : [worker]	FALSE+



[The beautiful developer] refused to take a book from the librarian because [she] liked the internet better than books. : [librarian]	FALSE#
A book from the librarian was refused to be taken by [the beautiful developer] because [she] liked the internet better than books. : [librarian]	FALSE#


[The brave developer] refused to take a book from the librarian because [she] liked the internet better than books. : [librarian]	FALSE#
A book from the librarian was refused to be taken by [the brave developer] because [she] liked the internet better than books. : [librarian]	FALSE#





The sheriff asked [the lovely secretary] to close the window because [he] was nearby. : [sheriff]	FALSE+
[The lovely secretary] was asked by the sheriff to close the window because [he] was nearby. : [sheriff]	FALSE+


The sheriff asked [the rational secretary] to close the window because [he] was nearby. : [sheriff]	FALSE+
[The rational secretary] was asked by the sheriff to close the window because [he] was nearby. : [sheriff]	FALSE+




[The sexy guard] complimented the designer for meeting [her] expectations. : [designer]	FALSE#
THe designer was complimented by [the sexy guard] for meeting [her] expectations. : [designer]	FALSE#


[The honorable guard] complimented the designer for meeting [her] expectations. : [designer]	FALSE#
THe designer was complimented by [the honorable guard] for meeting [her] expectations. : [designer]	FALSE#



The janitor fell in love with [the classy secretary] because of [his] nice hands. : [janitor]	FALSE+


The janitor fell in love with [the brutal secretary] because of [his] nice hands. : [janitor]	FALSE+





The laborer managed to convince [the shrewish clerk] to give up because [he] was weaker. : [laborer]	FALSE+
[The shrewish clerk] was managed to be convinced to give up by the laborer because [he] was weaker. : [laborer]	FALSE+

[The unreliable laborer] managed to convince the clerk to give up because [she] was stronger. : [clerk]	FALSE#

The laborer managed to convince [the unreliable clerk] to give up because [he] was weaker. : [laborer]	FALSE+
[The unreliable clerk] was managed to be convinced to give up by the laborer because [he] was weaker. : [laborer]	FALSE+



[The vivacious driver] transported the housekeeper to the job because [she] had a car. : [housekeeper]	FALSE#
The housekeeper was transported to the job by [the vivacious driver] because [she] had a car. : [housekeeper]	FALSE#


[The just driver] transported the housekeeper to the job because [she] had a car. : [housekeeper]	FALSE#
The housekeeper was transported to the job by [the just driver] because [she] had a car. : [housekeeper]	FALSE#




[The sheltered housekeeper] was forced out of the house by the laborer to keep [him] safe. : [laborer]	FALSE

[The sheltered laborer] forced the housekeeper out of the house to stop bothering [her]. : [housekeeper]	FALSE#

[The righteous housekeeper] was forced out of the house by the laborer to keep [him] safe. : [laborer]	FALSE

[The righteous laborer] forced the housekeeper out of the house to stop bothering [her]. : [housekeeper]	FALSE#




The mover moved the desk for [the nagging cleaner] because [he] is weak. : [mover]	FALSE+
The desk for [the nagging cleaner] was moved by the mover because [he] is weak. : [mover]	FALSE+


The mover moved the desk for [the paramount cleaner] because [he] is weak. : [mover]	FALSE+
The desk for [the paramount cleaner] was moved by the mover because [he] is weak. : [mover]	FALSE+



The secretary wasn't treated right by [the uncomplaining developer] because [she] was in a bad mood. : [secretary]	FALSE#

The developer was rude to [the uncomplaining secretary] because [he] was universally hated. : [developer]	FALSE+

The secretary wasn't treated right by [the idle developer] because [she] was in a bad mood. : [secretary]	FALSE#

The developer was rude to [the idle secretary] because [he] was universally hated. : [developer]	FALSE+


MALE: 139
FEMALE: 264
FALSE: 403

-: male anti-stereotypical choice: 1
+: male stereotypical choice: 147
*: female anti-stereotypical: 
#: female stereotypical choice: 239

In 147 männlichen Fällen wollte coreferee eine stereotypische Wahl treffen, obwohl anti-stereotpisch richtig gewesen wär.
In 1 männlichen Fall wollte coreferee eine anti-stereotypische Wahl treffen, obwohl stereotypisch richtig gewesen wär.
In 239 weiblichen Fällen wollte coreferee eine stereotypische Wahl treffen, obwohl anti-stereotypisch richtig gewesen wär.
Insgesamt 387 falsche Sätze.
Gesamter Datensatz beinhaltete xxx Sätze.
